#######################################################################################################################################################################################
#A......#.....#.....#.#.....#.#...#.#.......#.....#.#...#.......#...........#...#.............#.....#.......#.........#.....#.....#...........#.#...................#.....#...........#
#.#######.#.#.#.###.#.#####.#.#.#.#.#####.#.#.###.#.#######.#.###.#.#.#.#.#####.#.#########.#.###.#.#.#.#.#.#.#.#.###.#.#####.#.#.#.#.#.#.#.#.#.#.#.###.#####.#.#.#.#.#.#.#.#.#.#.#.#.#
#.....#.#.....#.#...#.......#.......#...#...#.#.......#.....#.....#.........#...#...#.....#.........#.#...#.#.#.#.#...#.#...#.....#...#...#...#.#...#.#.#.#...........#.#.......#.#...#
#.#####.#.#.#.#.#.###.###.#.###.#.#.#.###.#.#.#.#.#.#.###.#.#.#######.#.#.#.###.#.#.#.#.#######.#.###.###.#.#.###.#####.#.#.#.#####.###.#.#.#########.#.#.#.###.#####.#.#.#####.#.#.###
#...#...#.#.#.....#...#.............#.#.......#.......#.#...#.#.........#.......#.#.....#.......#.......................#.#...#.#.#...#...#.#.#...#...#.......#.........#...#.#.....#.#
#.#.###.#.#.#.#.#.#.#.#.#.###.#.#.#.#.#.###.###.###.#.#.#.#.###.###.###.#.#.#####.#.#.#.#.#.#.#.#.###.#.###########.#.#.#.#.#.#.#.###.###.#.#.#.#.#.#.#.#.#.#.#####.###.#.###.#.#####.#
#...#...#...#...#.#.#.#...#...#...#...#.....#...................#...#.#.....#...........#.....#.#.#...#.#...#.........#.#.......#...........#...#.....#...#.#...............#.#.......#
#.#.#.#.###.#.#.###.#######.#.#.#.#.#.#.###.#.###.#.#.#.###.#.#.#.#.#.#.#####.#.#.###.#.#.###.#.#.#.#.#.###.###.#.#.#.#####.#.###########.#.#.#.#########.#.#.###.###.###.#.#.###.#.#.#
#.#.........#...#.....#.....#.#...#...#.....#...............#...#.......#.#.#.......#.#...#.....#.#.#.........#.#.........#...#...#.........#.#...#.#.#...........#.....#.......#.....#
#.#.#.#.#.###.#.#.#.#.#.#.###.#########.#.#.###.#.#.#####.#####.#.#####.#.#.###.#.#.#.#.#.#.#.#.#.#.#.#.#.###.###.###.#.#.###.###.#.#.#.#.#.###.#.#.#.#.#.#####.###.#.#.#######.#.###.#
#...#.........#...#.#...#.#.#...........#.#.#...........#.......#.#.#.....#...#.#.#.#...#.......#.........#...#.....#...#.....#.#.....#.#...#.....#.#...#.....#.#.#.#.............#...#
#.#.###########.###.#.###.#.#####.#.#.#.###.#.###.#.#.#.#########.#.#.#####.#.#.#.#.#.#.#####.#.#.#.###.#.#.#.#.###############.#.###.#.#.#.#.#.###.###.#.#.#.#.#.#.#####.#.#.###.#.###
#.....#.#...........#.#.............#.#...........#.....#.#.....#...#.#.#.#...........#.#.....#...#.....#...#.....#...........#.#.#...#.........#.#.....#...#.......#.....#...#.......#
#####.#.#.#.#.#.#####.#.#####.#.#.#.#.###.#.#.###.#######.#.#.#####.#.#.#.#.#.#####.###.#.###.#.#.#.#####.#.#.###.#.###.#.###.#.#.###.#.###.###.#.#.#.#.###.#.#####.#.#.#.#####.#.###.#
#.....#.#.....#.#.......#.......#.....#...#...#...............#.....#...........#.........#.....#.#.#.............#.#...#.#.....#.#...#...#...#.........#.....#...#...#...........#...#
#.#.#.###.#.###.#.#.#.###.#.###.#.#.#.###.###.#.###.#.#.#.#####.#.#.#.###.#####.#####.#.#.#.###.#.###.###.#####.#.#.#.#.#.###.###.#.###.#.#.#.#.#.#####.#####.#.#.#.###.#.#.#.#####.###
#...#.....#.#.......#.....#.#.....#...#...#.#.#.....#...#.#...#.#.....................#.....#.....#.....#.......#.........#...#...#...#.#.#.#...#.#.#...#...#.....#.#.......#...#.....#
#####.###.###.#.#.#.#.#.#.###.#.#.#.#####.#.#.#.#.#.#######.#.#.#.#.#.#######.###.#.###.#.#.###.#.#.#.#.#.#####.#.#.#.###.#.###.###.#.###.#.###.#.#.#.#.###.#.###.###.#####.###.#.#####
#.....#.....#...#.....#.#...#...#.........#...................#.....#...#.........#.....#...........#...#.#.......#.#...#...#...............#.......#...#.........#.............#.....#
#.#.#.#.#######.#.#.#########.#######.###.#####.###.#.###.#.#######.#.###.#.###.###.###.#####.#####.###.#.#.#.#.#.#.#.###.#.#.#######.#.#.#.#.#.#.#.#.#####.#.#.#.#.#.#.###.#.#.###.#.#
#.#.#.......#...#.#...#.......#.................#.....#...#.......#.#.....#.....#.#...#.#.....#...#.#.......#...#.....#.....#.....#.......#.....#...#.#...#.....#...#.#.#...#...#.....#
###.#.#####.#.###.###.#.#.###.#.###.#####.#.#.#######.#.#########.#####.#.#.#.###.#.#.#.###.#######.#.#########.#.#.#.#.#.#.#####.###.###.###.#.#.#.#.#.#.#.###.#.#.#.#.#####.#.#.###.#
#.#...#.....#.....#.#.....#...#...#.#...#...#.#.#.#.....#.....#.#.#.#.....#.................#.#.#...#...#...#.#.#.#.#.#...#...#.#.............#.#...#...#.#.#.......#.........#.#.....#
#.###.#.###.#.#.#.#.###.#.#.###.#####.#.###.#.#.#.#.#.###.#.#.#.#.#.#.#.#.#.#.#####.###.#.###.#.#.###.#.#.#.#.#.#.#.#.#.###.#.#.###.#.#.#.#######.#.###.#.#.#.###.#.#.#.###.###.#.#.#.#
#.#...#.....#.....#.#...#...#.......#...#.....#.#.#.....#.#...#...#...#.#.........#.....#...#.#...#...#...#.#.#.......#...#.#...#...#.#...#.....#.......#.......#.#.....#.#...#.#.....#
#.#.#.#.#.#.#.###.#.###.#.#.#.###.###.#.#.###.###.#.#.#.#.###.#.#.#.#.#.#.#########.#.#.#.#.#.#######.#.###.#.#.#.#.#.#.###.#.###.#######.#.#.#.#.###.#.#.#.#.#.#.#.#####.###.#.#.###.#
#.....#.....#.#...#.#.#...#.....#.....#.#...#.....#.....#.....#.#.#...#...#.#.....#.#.#...#...#.......#.....#...........#...#.#...#.......#.......#.#.#...#.#...#.#.#...........#.....#
#.#####.#####.#####.#.###.#########.#.#.#.#.###.#.#.#.#.#.#.#.#####.###.#.#.#.###.#.###.#.#####.###.#####.#####.#.###.###.#.#.#.#.#.###.#.#.#####.#.#.###.###.###.#.#.#.#.#.###.###.#.#
#.....#...#...#.#...#.........#.................#.#.....#.#.....#.........#...#.....#...#.#.....#.......#.......#.....#.#.#.......#.#...#.#...#.#.........#.........#...#.....#.....#.#
#.###.#####.#.#.#.#.#.#######.#.#####.#########.#.#.###.#.#####.#.#####.###.#.#.#.#.###.#.#.#.#.###.#.#####.#.###.###.#.#.#.###.#.#.#.#.#.#.#.#.#.#####.#.#.###.#.#.#.#.#.#.#.###.###.#
#.#...#.#.....#...#.#.#.......#.#.................#...#.....#...............#.........#...#.#.#...#.#...#...#.........#.....#...........#.#...........#.....#.#.#.#...#...#...#.#.#...#
#.#.#.#.#.###.#######.#.#.#.###.#.#.#.###.#.#.###.###.#.###.#.#####.#.#.#.#.#.###.#########.#.#.#.#.#.#.#######.###.#.#.###.#.#.###.#.###.#.#.###.#.#.#.#.#.#.#.#.#.###.#####.#.###.#.#
#.#.....#.....#.#.......#...#...#...#.#...#.....#.......#...#...#...#.#.#...#...#.....#.#...#...........#.........#...#.#...#...#...#...#...........#.#.#...#...........#.....#.#.....#
###.#.###.#####.#.#.#.#.#.###.#.#.#####.#.#.#.#.#.#.#.###.###.#.#.###.#.###.###.#####.#.#.###.#.#.###.#.#.#.###.#####.###.#####.#.#.###.#.#####.#.#.#.#####.###.###.###.#.#.#.#.#.#.###
#.........#.....#.....#...#...............#.#...#.#.#.....#.#...#...#.#...............#.......#.......#.#...#.#...........#.#.#...............#...#.........#...............#...#...#.#
#.#.#.###.#.#####.#.#.#.#.#.#.###.###.###.#####.#.#####.###.#.#.###.#.###.###.#####.#####.#####.#########.###.#.#.#.#.#.#.#.#.#.#.#.#.###.#.#.###.#####.###.#####.###.#.###.###.#.#.#.#
#.....#.#.............#...#.......#.#.............#.#...#.#...#...#.#.....#.#.#...#.#.....#...#...........#.....#.#.#...#...................#.....#.....#...............#.....#.#.....#
#.#####.#.###.#.#######.###.###.#.#.#.###.###.#.###.#.#.#.###.#.#.#.#####.#.###.###.#########.#.#####.#.#.#.#.#.#.#.#####.#########.#.#.#.#.###.###.#.#####.#.#.###.#####.#.#.###.###.#
#...#.....#.#.#.#...............#.........#.....#.......#.........#...........#...#.......#.#...#.......#.....#...#.#...#.#...#.#.....#...........#.................#...#.#.#.#...#.#.#
#.#.#.#####.#.###.###.#.#.#####.#.#####.###.#.###.#.#######.#.#.###.###.###.#.#.#.#.#.#.#.#.#.#.#.#.#######.#######.#.#.###.###.#.###.#.###.#.#.#.#.#.#######.#.#.###.#.###.#####.#.#.#
#.....#.#.....#...#...#.#.......#...#.............#...#.....#...#.#.......#.....#...#...#.#.....#.#...........#.......#.#...#...#.#...#.#.#.....#...............#...#.#.#...#...#.....#
#####.#.#.#.###.#.###.#.#####.#######.#############.#.#.#.#.#.###.#.#.###.#.#####.#.#.#.#####.#.#.###.###.#.#.#.###.#.#.###.#.#.#.#.#.#.#.#.#.###.###.#.#######.###.#.#####.#######.###
#.....#...........#.....#.....#.......#...#...#.......#.....#.#...#.#.#...#.#...#.....#.......#...#...#...#.#.#.#.....#.....#...#.#...#.......#...#...#.....#...#...#.........#.#....B#
#######################################################################################################################################################################################