##########
#A...#...#
#.#.##.#.#
#.#.##.#.#
#.#....#B#
#.#.##.#.#
#....#...#
##########


#####
#A..#
#.#B#
#...#
#####